-.S.-.-.-.-.-.-.-.-
S.W.S.-.-.-.-.-.-.-
-.S.-.-.S.-.S.W.S.-
-.-.-.S.W.S.B.S.-.-
-.-.G.-.S.B.P.B.B.-
-.-.-.G.-.-.B.B.P.B
-.G-.-.-.G.-.-.B.-
-.B.-.G.-.-.-.G.-.-
B.P.B.-.-.G.-.-.-.-
-.B.-.-.-.-.-.-.-.G
50